Trace1,Trace2,Judge,Time1,Time2,Time3
T9_samples4.csv,T4_samples7.csv,4,63044,5651,68695
T9_samples4.csv,T2_samples2.csv,5,23573,3169,26742
T9_samples4.csv,T1_samples4.csv,5,19783,2719,22502
T9_samples4.csv,T2_samples5.csv,5,33924,3066,36990
T9_samples4.csv,T8_samples2.csv,5,46851,2621,49472
T9_samples4.csv,T4_samples3.csv,4,39625,2843,42468
T9_samples4.csv,T4_samples1.csv,4,24904,2568,27472
T9_samples4.csv,T2_samples3.csv,4,17696,18311,36007
T9_samples4.csv,T1_samples1.csv,5,11844,2326,14170
T9_samples4.csv,T2_samples1.csv,5,15141,2386,17527
T9_samples4.csv,T1_samples3.csv,4,22904,2880,25784
T9_samples4.csv,T2_samples4.csv,3,17575,2461,20036
T9_samples4.csv,T8_samples1.csv,5,19729,2395,22124
T9_samples4.csv,T4_samples2.csv,5,23647,2552,26199
T9_samples4.csv,T8_samples5.csv,5,17932,2885,20817
T9_samples1.csv,T4_samples7.csv,5,35118,2528,37646
T9_samples1.csv,T2_samples2.csv,5,28593,2341,30934
T9_samples1.csv,T2_samples5.csv,4,45249,2507,47756
T9_samples1.csv,T8_samples2.csv,5,26437,2330,28767
T9_samples1.csv,T8_samples6.csv,5,32197,19276,51473
T9_samples1.csv,T4_samples1.csv,5,22522,2585,25107
T9_samples1.csv,T4_samples6.csv,4,295,29011,29306
T9_samples1.csv,T2_samples3.csv,4,18828,10321,29149
T9_samples1.csv,T2_samples1.csv,5,13754,2119,15873
T9_samples1.csv,T2_samples4.csv,4,14191,2375,16566
T9_samples1.csv,T8_samples1.csv,5,3338,30277,33615
T9_samples1.csv,T8_samples5.csv,4,24289,2502,26791
T4_samples5.csv,T8_samples2.csv,5,58989,2971,61960
T4_samples5.csv,T8_samples4.csv,5,16960,2324,19284
T4_samples5.csv,T8_samples3.csv,5,13111,2440,15551
T9_samples1.csv,T4_samples7.csv,5,30240,2403,32643
T9_samples1.csv,T2_samples2.csv,5,22664,2770,25434
T9_samples1.csv,T2_samples5.csv,3,26348,2723,29071
T9_samples1.csv,T8_samples2.csv,4,20825,2489,23314
T9_samples1.csv,T8_samples6.csv,4,13810,2579,16389
T9_samples1.csv,T4_samples1.csv,5,15281,2358,17639
T9_samples1.csv,T4_samples6.csv,4,39125,2432,41557
T9_samples1.csv,T2_samples3.csv,5,21077,8889,29966
T9_samples1.csv,T2_samples1.csv,5,10916,2814,13730
T9_samples1.csv,T2_samples4.csv,5,15228,2161,17389
T9_samples1.csv,T8_samples1.csv,5,10664,1832,12496
T9_samples1.csv,T8_samples5.csv,5,12277,2468,14745
T4_samples5.csv,T8_samples2.csv,5,24208,2134,26342
T4_samples5.csv,T8_samples4.csv,5,15381,2386,17767
T4_samples5.csv,T8_samples3.csv,5,12084,2181,14265
T8_samples7.csv,T2_samples2.csv,4,32830,1716,34546
T8_samples7.csv,T4_samples3.csv,3,41605,1941,43546
T8_samples7.csv,T4_samples1.csv,4,14439,2977,17416
T8_samples7.csv,T2_samples3.csv,4,20413,2030,22443
T8_samples7.csv,T4_samples6.csv,5,18550,1974,20524
T8_samples7.csv,T4_samples4.csv,5,14548,1698,16246
T8_samples7.csv,T4_samples2.csv,4,20152,1628,21780
T4_samples3.csv,T8_samples6.csv,5,3469,25229,28698
T4_samples3.csv,T9_samples4.csv,4,20063,3075,23138
T4_samples3.csv,T8_samples1.csv,5,13059,1726,14785
T4_samples3.csv,T8_samples7.csv,5,13158,1235,14393
T4_samples3.csv,T8_samples5.csv,5,12368,1195,13563
T2_samples2.csv,T4_samples7.csv,5,31686,1554,33240
T2_samples2.csv,T9_samples2.csv,3,19968,1515,21483
T2_samples2.csv,T8_samples6.csv,4,33720,2288,36008
T2_samples2.csv,T4_samples1.csv,4,31660,8708,40368
T2_samples2.csv,T4_samples6.csv,4,15427,5543,20970
T2_samples2.csv,T9_samples4.csv,5,19386,1830,21216
T2_samples2.csv,T1_samples3.csv,4,28017,1697,29714
T2_samples2.csv,T8_samples1.csv,5,18964,2085,21049
T2_samples2.csv,T8_samples7.csv,4,15517,1132,16649
T2_samples2.csv,T9_samples3.csv,3,29105,1135,30240
T2_samples2.csv,T4_samples2.csv,5,19808,1985,21793
T2_samples2.csv,T9_samples1.csv,4,22077,1738,23815
T4_samples3.csv,T8_samples6.csv,4,53047,1730,54777
T4_samples3.csv,T9_samples4.csv,5,34863,2425,37288
T4_samples3.csv,T8_samples1.csv,4,24920,2001,26921
T4_samples3.csv,T8_samples7.csv,5,9130,1576,10706
T4_samples3.csv,T8_samples5.csv,5,11518,1640,13158
T4_samples3.csv,T8_samples6.csv,5,24923,1080,26003
T4_samples3.csv,T9_samples4.csv,4,11106,1402,12508
T4_samples3.csv,T8_samples1.csv,3,815,20269,21084
T4_samples3.csv,T8_samples7.csv,5,8157,1731,9888
T4_samples3.csv,T8_samples5.csv,5,8214,1944,10158
T8_samples2.csv,T4_samples7.csv,5,71225,1696,72921
T8_samples2.csv,T2_samples5.csv,2,34216,1412,35628
T8_samples2.csv,T4_samples5.csv,5,32625,1128,33753
T8_samples2.csv,T4_samples6.csv,5,16130,1818,17948
T8_samples2.csv,T9_samples4.csv,4,16884,1241,18125
T8_samples2.csv,T2_samples4.csv,3,20180,1856,22036
T8_samples2.csv,T4_samples2.csv,4,24116,752,24868
T8_samples2.csv,T9_samples1.csv,2,16315,1684,17999
T4_samples4.csv,T1_samples4.csv,4,20796,1696,22492
T4_samples4.csv,T8_samples7.csv,4,20189,2472,22661
T9_samples3.csv,T4_samples7.csv,4,19801,1534,21335
T9_samples3.csv,T2_samples2.csv,5,20435,1845,22280
T9_samples3.csv,T2_samples5.csv,4,17643,1907,19550
T9_samples3.csv,T2_samples3.csv,4,10080,1038,11118
T9_samples3.csv,T4_samples6.csv,4,13762,1083,14845
T9_samples3.csv,T2_samples1.csv,5,16570,1890,18460
T9_samples3.csv,T8_samples1.csv,4,13901,2330,16231
T1_samples4.csv,T9_samples4.csv,3,22451,1678,24129
T1_samples4.csv,T2_samples3.csv,3,11605,2422,14027
T1_samples4.csv,T4_samples4.csv,4,14991,2268,17259
T8_samples6.csv,T4_samples7.csv,4,17059,783,17842
T8_samples6.csv,T2_samples2.csv,3,17204,942,18146
T8_samples6.csv,T4_samples3.csv,4,23025,2012,25037
T8_samples6.csv,T4_samples1.csv,4,15521,1488,17009
T8_samples6.csv,T9_samples1.csv,3,16863,1342,18205
T8_samples4.csv,T4_samples7.csv,4,15923,1473,17396
T8_samples4.csv,T4_samples5.csv,3,16822,2636,19458
T8_samples4.csv,T4_samples6.csv,3,14518,1063,15581
T8_samples4.csv,T1_samples1.csv,4,11903,1311,13214
T8_samples4.csv,T4_samples2.csv,4,22322,1978,24300
T2_samples5.csv,T4_samples7.csv,5,17163,1396,18559
T2_samples5.csv,T9_samples2.csv,4,11901,1387,13288
T2_samples5.csv,T8_samples2.csv,4,23205,2130,25335
T2_samples5.csv,T1_samples5.csv,4,18684,1053,19737
T2_samples5.csv,T9_samples4.csv,5,16201,1041,17242
T2_samples5.csv,T8_samples1.csv,5,9641,1516,11157
T2_samples5.csv,T9_samples3.csv,4,12333,2869,15202
T2_samples5.csv,T4_samples2.csv,4,11689,1170,12859
T2_samples5.csv,T9_samples1.csv,3,14420,1895,16315
T8_samples6.csv,T4_samples7.csv,3,25030,2155,27185
T8_samples6.csv,T2_samples2.csv,4,23114,1171,24285
T8_samples6.csv,T4_samples3.csv,4,22532,1125,23657
T8_samples6.csv,T4_samples1.csv,3,12582,1192,13774
T8_samples6.csv,T9_samples1.csv,2,13281,2380,15661
T1_samples1.csv,T4_samples7.csv,3,26288,1915,28203
T1_samples1.csv,T9_samples2.csv,2,15700,1500,17200
T1_samples1.csv,T8_samples4.csv,4,24838,1751,26589
T1_samples1.csv,T9_samples4.csv,2,21383,1296,22679
T1_samples1.csv,T8_samples3.csv,5,12726,1890,14616
T9_samples1.csv,T4_samples7.csv,4,13419,1141,14560
T9_samples1.csv,T2_samples2.csv,4,12669,1098,13767
T9_samples1.csv,T2_samples5.csv,4,18732,1147,19879
T9_samples1.csv,T8_samples2.csv,4,12336,1617,13953
T9_samples1.csv,T8_samples6.csv,4,8893,5274,14167
T9_samples1.csv,T4_samples1.csv,5,10327,1599,11926
T9_samples1.csv,T4_samples6.csv,4,15693,9160,24853
T9_samples1.csv,T2_samples3.csv,4,15474,1118,16592
T9_samples1.csv,T2_samples1.csv,5,9799,1843,11642
T9_samples1.csv,T2_samples4.csv,5,10763,1932,12695
T9_samples1.csv,T8_samples1.csv,4,16058,2387,18445
T9_samples1.csv,T8_samples5.csv,4,9401,1759,11160
T2_samples1.csv,T9_samples2.csv,2,24693,1640,26333
T2_samples1.csv,T4_samples1.csv,4,26897,6429,33326
T2_samples1.csv,T9_samples4.csv,4,15405,2070,17475
T2_samples1.csv,T4_samples6.csv,4,22409,1843,24252
T2_samples1.csv,T1_samples3.csv,4,34988,1919,36907
T2_samples1.csv,T8_samples1.csv,5,16531,1285,17816
T2_samples1.csv,T9_samples3.csv,3,22895,1248,24143
T2_samples1.csv,T4_samples2.csv,2,21712,1179,22891
T2_samples1.csv,T9_samples1.csv,3,19685,1098,20783
T9_samples3.csv,T4_samples7.csv,4,19067,1394,20461
T9_samples3.csv,T2_samples2.csv,4,22138,1763,23901
T9_samples3.csv,T2_samples5.csv,4,31543,1073,32616
T9_samples3.csv,T2_samples3.csv,4,18048,996,19044
T9_samples3.csv,T4_samples6.csv,4,14878,1138,16016
T9_samples3.csv,T2_samples1.csv,5,15853,2175,18028
T9_samples3.csv,T8_samples1.csv,5,10635,1272,11907
T1_samples5.csv,T2_samples5.csv,2,21904,2640,24544
T1_samples5.csv,T4_samples6.csv,5,15190,2109,17299
T1_samples5.csv,T8_samples5.csv,5,10498,910,11408
T2_samples3.csv,T4_samples7.csv,3,22467,2629,25096
T2_samples3.csv,T1_samples4.csv,4,16139,962,17101
T2_samples3.csv,T9_samples2.csv,2,15636,1183,16819
T2_samples3.csv,T9_samples4.csv,5,15726,1275,17001
T2_samples3.csv,T1_samples3.csv,4,21292,2261,23553
T2_samples3.csv,T8_samples1.csv,5,11298,1176,12474
T2_samples3.csv,T8_samples7.csv,3,17983,2064,20047
T2_samples3.csv,T9_samples3.csv,3,14968,1669,16637
T2_samples3.csv,T4_samples2.csv,4,12033,1622,13655
T2_samples3.csv,T9_samples1.csv,4,10280,3411,13691
T8_samples2.csv,T4_samples7.csv,3,11893,4498,16391
T8_samples2.csv,T2_samples5.csv,2,13393,1047,14440
T8_samples2.csv,T4_samples5.csv,4,11019,972,11991
T8_samples2.csv,T4_samples6.csv,4,11269,1024,12293
T8_samples2.csv,T9_samples4.csv,3,21822,1968,23790
T8_samples2.csv,T2_samples4.csv,2,10019,1568,11587
T8_samples2.csv,T4_samples2.csv,4,12636,1578,14214
T8_samples2.csv,T9_samples1.csv,2,10405,5309,15714
T8_samples2.csv,T4_samples7.csv,4,17442,1076,18518
T8_samples2.csv,T2_samples5.csv,2,9243,1056,10299
T8_samples2.csv,T4_samples5.csv,4,16457,1823,18280
T8_samples2.csv,T4_samples6.csv,4,13888,1580,15468
T8_samples2.csv,T9_samples4.csv,2,10898,1152,12050
T8_samples2.csv,T2_samples4.csv,2,15744,1517,17261
T8_samples2.csv,T4_samples2.csv,3,19168,1023,20191
T8_samples2.csv,T9_samples1.csv,3,8863,1751,10614
T1_samples1.csv,T4_samples7.csv,3,23298,1077,24375
T1_samples1.csv,T9_samples2.csv,3,14165,1661,15826
T1_samples1.csv,T8_samples4.csv,4,18856,1004,19860
T1_samples1.csv,T9_samples4.csv,4,16676,3033,19709
T1_samples1.csv,T8_samples3.csv,4,9668,937,10605
T4_samples3.csv,T8_samples6.csv,4,16669,1668,18337
T4_samples3.csv,T9_samples4.csv,4,20905,1774,22679
T4_samples3.csv,T8_samples1.csv,3,21925,1787,23712
T4_samples3.csv,T8_samples7.csv,5,8226,1317,9543
T4_samples3.csv,T8_samples5.csv,4,11646,1168,12814
T9_samples2.csv,T4_samples7.csv,4,16442,1796,18238
T9_samples2.csv,T2_samples2.csv,4,19110,1082,20192
T9_samples2.csv,T2_samples5.csv,5,11005,2533,13538
T9_samples2.csv,T2_samples3.csv,4,8039,1076,9115
T9_samples2.csv,T1_samples1.csv,4,15306,1851,17157
T9_samples2.csv,T2_samples1.csv,4,8756,1415,10171
T9_samples2.csv,T1_samples3.csv,2,11666,1314,12980
T9_samples2.csv,T2_samples4.csv,5,9264,992,10256
T9_samples2.csv,T8_samples1.csv,5,9481,1154,10635
T2_samples5.csv,T4_samples7.csv,4,24575,1795,26370
T2_samples5.csv,T9_samples2.csv,5,22660,1720,24380
T2_samples5.csv,T8_samples2.csv,4,19366,2140,21506
T2_samples5.csv,T1_samples5.csv,4,16126,3729,19855
T2_samples5.csv,T9_samples4.csv,4,14379,1530,15909
T2_samples5.csv,T8_samples1.csv,4,9917,882,10799
T2_samples5.csv,T9_samples3.csv,4,28171,1641,29812
T2_samples5.csv,T4_samples2.csv,5,11039,1116,12155
T2_samples5.csv,T9_samples1.csv,4,13410,979,14389
T8_samples3.csv,T4_samples7.csv,4,13917,978,14895
T8_samples3.csv,T4_samples5.csv,3,32365,1029,33394
T8_samples3.csv,T4_samples6.csv,5,11761,1635,13396
T8_samples3.csv,T1_samples1.csv,4,12900,1172,14072
T2_samples2.csv,T4_samples7.csv,3,22241,1179,23420
T2_samples2.csv,T9_samples2.csv,3,11244,2802,14046
T2_samples2.csv,T8_samples6.csv,4,12471,1525,13996
T2_samples2.csv,T4_samples1.csv,3,14694,977,15671
T2_samples2.csv,T4_samples6.csv,4,11041,1729,12770
T2_samples2.csv,T9_samples4.csv,5,12199,2076,14275
T2_samples2.csv,T1_samples3.csv,3,12390,1645,14035
T2_samples2.csv,T8_samples1.csv,5,8712,932,9644
T2_samples2.csv,T8_samples7.csv,4,10288,972,11260
T2_samples2.csv,T9_samples3.csv,4,11051,1840,12891
T2_samples2.csv,T4_samples2.csv,4,36806,995,37801
T2_samples2.csv,T9_samples1.csv,4,9151,1069,10220
T8_samples7.csv,T2_samples2.csv,4,32132,1471,33603
T8_samples7.csv,T4_samples3.csv,4,18261,896,19157
T8_samples7.csv,T4_samples1.csv,4,10785,1688,12473
T8_samples7.csv,T2_samples3.csv,4,9838,1326,11164
T8_samples7.csv,T4_samples6.csv,5,9695,1047,10742
T8_samples7.csv,T4_samples4.csv,4,11825,923,12748
T8_samples7.csv,T4_samples2.csv,4,14290,1248,15538
T2_samples2.csv,T4_samples7.csv,4,12695,972,13667
T2_samples2.csv,T9_samples2.csv,3,15189,997,16186
T2_samples2.csv,T8_samples6.csv,4,19014,972,19986
T2_samples2.csv,T4_samples1.csv,4,28829,1970,30799
T2_samples2.csv,T4_samples6.csv,4,11466,1277,12743
T2_samples2.csv,T9_samples4.csv,5,9819,1745,11564
T2_samples2.csv,T1_samples3.csv,3,10434,925,11359
T2_samples2.csv,T8_samples1.csv,5,12154,862,13016
T2_samples2.csv,T8_samples7.csv,4,8703,825,9528
T2_samples2.csv,T9_samples3.csv,4,11931,810,12741
T2_samples2.csv,T4_samples2.csv,4,7862,869,8731
T2_samples2.csv,T9_samples1.csv,4,11764,3385,15149
T4_samples2.csv,T2_samples2.csv,3,19937,4551,24488
T4_samples2.csv,T2_samples5.csv,4,12574,931,13505
T4_samples2.csv,T8_samples2.csv,4,8769,1704,10473
T4_samples2.csv,T8_samples4.csv,4,19526,20135,39661
T4_samples2.csv,T9_samples4.csv,4,14661,1483,16144
T4_samples2.csv,T2_samples3.csv,3,15281,1332,16613
T4_samples2.csv,T2_samples1.csv,3,11889,1039,12928
T4_samples2.csv,T2_samples4.csv,4,10591,1226,11817
T4_samples2.csv,T8_samples1.csv,5,10218,1640,11858
T4_samples2.csv,T8_samples7.csv,5,6130,1804,7934
T4_samples2.csv,T8_samples5.csv,5,13500,1313,14813
T2_samples5.csv,T4_samples7.csv,4,16879,844,17723
T2_samples5.csv,T9_samples2.csv,3,24164,1244,25408
T2_samples5.csv,T8_samples2.csv,5,8702,8296,16998
T2_samples5.csv,T1_samples5.csv,4,17325,8889,26214
T2_samples5.csv,T9_samples4.csv,4,13524,1941,15465
T2_samples5.csv,T8_samples1.csv,5,8847,8432,17279
T2_samples5.csv,T9_samples3.csv,4,8851,991,9842
T2_samples5.csv,T4_samples2.csv,4,7911,915,8826
T2_samples5.csv,T9_samples1.csv,3,9652,1168,10820
T1_samples4.csv,T9_samples4.csv,3,15239,1075,16314
T1_samples4.csv,T2_samples3.csv,4,17770,1405,19175
T1_samples4.csv,T4_samples4.csv,4,22773,8133,30906
T9_samples4.csv,T4_samples7.csv,3,21705,2701,24406
T9_samples4.csv,T2_samples2.csv,4,12545,1077,13622
T9_samples4.csv,T1_samples4.csv,4,16848,3531,20379
T9_samples4.csv,T2_samples5.csv,3,13514,7973,21487
T9_samples4.csv,T8_samples2.csv,5,12929,8043,20972
T9_samples4.csv,T4_samples3.csv,3,19741,28582,48323
T9_samples4.csv,T4_samples1.csv,4,16059,2323,18382
T9_samples4.csv,T2_samples3.csv,4,9182,12316,21498
T9_samples4.csv,T1_samples1.csv,5,1835,11962,13797
T9_samples4.csv,T2_samples1.csv,4,11945,971,12916
T9_samples4.csv,T1_samples3.csv,3,9412,7786,17198
T9_samples4.csv,T2_samples4.csv,4,1492,15524,17016
T9_samples4.csv,T8_samples1.csv,5,9590,1844,11434
T9_samples4.csv,T4_samples2.csv,5,12730,11789,24519
T9_samples4.csv,T8_samples5.csv,5,11300,839,12139
T4_samples1.csv,T2_samples2.csv,4,47209,1477,48686
T4_samples1.csv,T8_samples6.csv,4,17191,1549,18740
T4_samples1.csv,T9_samples4.csv,4,17653,1627,19280
T4_samples1.csv,T2_samples1.csv,3,10799,1581,12380
T4_samples1.csv,T2_samples4.csv,3,15799,1055,16854
T4_samples1.csv,T8_samples7.csv,4,15871,1499,17370
T4_samples1.csv,T9_samples1.csv,2,21607,1497,23104
T4_samples1.csv,T8_samples5.csv,5,17714,911,18625
T2_samples3.csv,T4_samples7.csv,5,20538,2206,22744
T2_samples3.csv,T1_samples4.csv,4,16152,972,17124
T2_samples3.csv,T9_samples2.csv,3,15339,773,16112
T2_samples3.csv,T9_samples4.csv,5,13699,1000,14699
T2_samples3.csv,T1_samples3.csv,3,20629,1779,22408
T2_samples3.csv,T8_samples1.csv,5,8940,1233,10173
T2_samples3.csv,T8_samples7.csv,4,20536,1096,21632
T2_samples3.csv,T9_samples3.csv,3,23116,1132,24248
T2_samples3.csv,T4_samples2.csv,4,21714,1401,23115
T2_samples3.csv,T9_samples1.csv,3,19914,859,20773
T4_samples7.csv,T2_samples2.csv,3,35183,1223,36406
T4_samples7.csv,T9_samples2.csv,3,15253,916,16169
T4_samples7.csv,T2_samples5.csv,3,20378,1191,21569
T4_samples7.csv,T8_samples2.csv,5,12396,1228,13624
T4_samples7.csv,T8_samples6.csv,4,26295,1032,27327
T4_samples7.csv,T8_samples4.csv,5,8479,997,9476
T4_samples7.csv,T2_samples3.csv,1,17883,2301,20184
T4_samples7.csv,T9_samples4.csv,4,30109,1148,31257
T4_samples7.csv,T1_samples1.csv,4,21567,40663,62230
T4_samples7.csv,T2_samples4.csv,4,15536,2276,17812
T4_samples7.csv,T8_samples1.csv,5,10907,2669,13576
T4_samples7.csv,T9_samples3.csv,3,27835,1167,29002
T4_samples7.csv,T8_samples3.csv,5,9700,1036,10736
T4_samples7.csv,T8_samples5.csv,4,9483,1111,10594
T4_samples7.csv,T9_samples1.csv,2,17116,1268,18384
T8_samples6.csv,T4_samples7.csv,4,26844,2132,28976
T8_samples6.csv,T2_samples2.csv,3,15992,976,16968
T8_samples6.csv,T4_samples3.csv,3,25440,954,26394
T8_samples6.csv,T4_samples1.csv,3,31789,5641,37430
T8_samples6.csv,T9_samples1.csv,3,11698,779,12477
T1_samples4.csv,T9_samples4.csv,4,24705,1551,26256
T1_samples4.csv,T2_samples3.csv,4,10666,4851,15517
T1_samples4.csv,T4_samples4.csv,5,17166,11299,28465
T4_samples7.csv,T2_samples2.csv,4,16533,1183,17716
T4_samples7.csv,T9_samples2.csv,3,11659,1060,12719
T4_samples7.csv,T2_samples5.csv,2,15225,1879,17104
T4_samples7.csv,T8_samples2.csv,5,16309,1171,17480
T4_samples7.csv,T8_samples6.csv,5,15625,5419,21044
T4_samples7.csv,T8_samples4.csv,5,9699,910,10609
T4_samples7.csv,T2_samples3.csv,4,9620,3723,13343
T4_samples7.csv,T9_samples4.csv,3,12087,985,13072
T4_samples7.csv,T1_samples1.csv,4,15085,1250,16335
T4_samples7.csv,T2_samples4.csv,3,14889,1592,16481
T4_samples7.csv,T8_samples1.csv,4,22458,1833,24291
T4_samples7.csv,T9_samples3.csv,2,11499,1273,12772
T4_samples7.csv,T8_samples3.csv,5,9095,1037,10132
T4_samples7.csv,T8_samples5.csv,5,11969,998,12967
T4_samples7.csv,T9_samples1.csv,2,24000,1491,25491
T4_samples2.csv,T2_samples2.csv,2,37163,946,38109
T4_samples2.csv,T2_samples5.csv,3,11415,1275,12690
T4_samples2.csv,T8_samples2.csv,4,20445,1326,21771
T4_samples2.csv,T8_samples4.csv,4,26243,1938,28181
T4_samples2.csv,T9_samples4.csv,2,20208,1005,21213
T4_samples2.csv,T2_samples3.csv,3,12371,1903,14274
T4_samples2.csv,T2_samples1.csv,4,14756,926,15682
T4_samples2.csv,T2_samples4.csv,5,11008,898,11906
T4_samples2.csv,T8_samples1.csv,5,9192,878,10070
T4_samples2.csv,T8_samples7.csv,4,8062,966,9028
T4_samples2.csv,T8_samples5.csv,5,15520,1003,16523
T8_samples4.csv,T4_samples7.csv,4,36088,1871,37959
T8_samples4.csv,T4_samples5.csv,4,10222,1732,11954
T8_samples4.csv,T4_samples6.csv,3,15474,844,16318
T8_samples4.csv,T1_samples1.csv,4,11578,903,12481
T8_samples4.csv,T4_samples2.csv,3,11482,1128,12610
T8_samples6.csv,T4_samples7.csv,4,15803,1147,16950
T8_samples6.csv,T2_samples2.csv,3,15092,987,16079
T8_samples6.csv,T4_samples3.csv,4,8628,1643,10271
T8_samples6.csv,T4_samples1.csv,4,10035,907,10942
T8_samples6.csv,T9_samples1.csv,3,15420,953,16373
T9_samples4.csv,T4_samples7.csv,4,23399,880,24279
T9_samples4.csv,T2_samples2.csv,4,7701,1051,8752
T9_samples4.csv,T1_samples4.csv,5,9488,905,10393
T9_samples4.csv,T2_samples5.csv,2,12089,1745,13834
T9_samples4.csv,T8_samples2.csv,4,14792,970,15762
T9_samples4.csv,T4_samples3.csv,4,19179,2023,21202
T9_samples4.csv,T4_samples1.csv,4,10995,3744,14739
T9_samples4.csv,T2_samples3.csv,3,9900,1305,11205
T9_samples4.csv,T1_samples1.csv,4,7393,1691,9084
T9_samples4.csv,T2_samples1.csv,4,7591,1075,8666
T9_samples4.csv,T1_samples3.csv,4,9689,4206,13895
T9_samples4.csv,T2_samples4.csv,3,7519,941,8460
T9_samples4.csv,T8_samples1.csv,5,7815,886,8701
T9_samples4.csv,T4_samples2.csv,4,11739,1778,13517
T9_samples4.csv,T8_samples5.csv,5,8945,845,9790
T4_samples5.csv,T8_samples2.csv,5,23571,1161,24732
T4_samples5.csv,T8_samples4.csv,5,8980,2671,11651
T4_samples5.csv,T8_samples3.csv,5,8007,1135,9142
T9_samples2.csv,T4_samples7.csv,5,16154,1848,18002
T9_samples2.csv,T2_samples2.csv,4,11340,1065,12405
T9_samples2.csv,T2_samples5.csv,4,7943,2097,10040
T9_samples2.csv,T2_samples3.csv,3,12622,1257,13879
T9_samples2.csv,T1_samples1.csv,4,9044,961,10005
T9_samples2.csv,T2_samples1.csv,4,9688,1007,10695
T9_samples2.csv,T1_samples3.csv,3,7731,4857,12588
T9_samples2.csv,T2_samples4.csv,4,10785,1265,12050
T9_samples2.csv,T8_samples1.csv,4,8755,906,9661
T2_samples5.csv,T4_samples7.csv,4,10498,3970,14468
T2_samples5.csv,T9_samples2.csv,5,20608,961,21569
T2_samples5.csv,T8_samples2.csv,3,12348,913,13261
T2_samples5.csv,T1_samples5.csv,4,11586,934,12520
T2_samples5.csv,T9_samples4.csv,5,14344,854,15198
T2_samples5.csv,T8_samples1.csv,3,19720,1679,21399
T2_samples5.csv,T9_samples3.csv,5,11037,844,11881
T2_samples5.csv,T4_samples2.csv,5,14664,1790,16454
T2_samples5.csv,T9_samples1.csv,5,14017,2016,16033
T2_samples4.csv,T4_samples7.csv,4,20681,2525,23206
T2_samples4.csv,T9_samples2.csv,4,11295,6644,17939
T2_samples4.csv,T8_samples2.csv,4,10806,855,11661
T2_samples4.csv,T4_samples1.csv,4,18556,932,19488
T2_samples4.csv,T9_samples4.csv,4,18138,1220,19358
T2_samples4.csv,T4_samples2.csv,4,15359,957,16316
T2_samples4.csv,T9_samples1.csv,4,11198,909,12107
T2_samples4.csv,T8_samples5.csv,3,14479,1063,15542
T9_samples3.csv,T4_samples7.csv,4,16495,8644,25139
T9_samples3.csv,T2_samples2.csv,3,39980,1020,41000
T9_samples3.csv,T2_samples5.csv,4,21587,1335,22922
T9_samples3.csv,T2_samples3.csv,3,12958,929,13887
T9_samples3.csv,T4_samples6.csv,4,19524,1606,21130
T9_samples3.csv,T2_samples1.csv,4,10455,1475,11930
T9_samples3.csv,T8_samples1.csv,3,12444,1009,13453
T8_samples2.csv,T4_samples7.csv,4,20637,1337,21974
T8_samples2.csv,T2_samples5.csv,2,19254,1120,20374
T8_samples2.csv,T4_samples5.csv,5,12796,1357,14153
T8_samples2.csv,T4_samples6.csv,5,6896,1622,8518
T8_samples2.csv,T9_samples4.csv,3,21007,1759,22766
T8_samples2.csv,T2_samples4.csv,2,10179,1575,11754
T8_samples2.csv,T4_samples2.csv,4,19697,952,20649
T8_samples2.csv,T9_samples1.csv,2,11179,1164,12343
T1_samples4.csv,T9_samples4.csv,3,53503,2232,55735
T1_samples4.csv,T2_samples3.csv,3,12261,2726,14987
T1_samples4.csv,T4_samples4.csv,4,22701,911,23612
T2_samples2.csv,T4_samples7.csv,4,17922,7687,25609
T2_samples2.csv,T9_samples2.csv,4,98366,2377,100743
T2_samples2.csv,T8_samples6.csv,4,23578,1160,24738
T2_samples2.csv,T4_samples1.csv,3,54812,2592,57404
T2_samples2.csv,T4_samples6.csv,4,15457,953,16410
T2_samples2.csv,T9_samples4.csv,5,9269,984,10253
T2_samples2.csv,T1_samples3.csv,3,22698,1469,24167
T2_samples2.csv,T8_samples1.csv,5,8796,906,9702
T2_samples2.csv,T8_samples7.csv,2,12310,1468,13778
T2_samples2.csv,T9_samples3.csv,4,7961,818,8779
T2_samples2.csv,T4_samples2.csv,4,17672,1220,18892
T2_samples2.csv,T9_samples1.csv,4,19484,4417,23901
T1_samples1.csv,T4_samples7.csv,4,30470,1196,31666
T1_samples1.csv,T9_samples2.csv,3,14195,5389,19584
T1_samples1.csv,T8_samples4.csv,5,10559,976,11535
T1_samples1.csv,T9_samples4.csv,4,44882,1082,45964
T1_samples1.csv,T8_samples3.csv,5,9544,1172,10716
T1_samples4.csv,T9_samples4.csv,3,31499,847,32346
T1_samples4.csv,T2_samples3.csv,3,16898,1484,18382
T1_samples4.csv,T4_samples4.csv,5,16007,1630,17637
T8_samples6.csv,T4_samples7.csv,4,12811,959,13770
T8_samples6.csv,T2_samples2.csv,3,70273,1818,72091
T8_samples6.csv,T4_samples3.csv,4,17324,1291,18615
T2_samples4.csv,T4_samples7.csv,4,18784,982,19766
T2_samples4.csv,T9_samples2.csv,4,44335,4541,48876
T2_samples4.csv,T8_samples2.csv,4,15927,978,16905
T2_samples4.csv,T4_samples1.csv,4,9558,879,10437
T2_samples4.csv,T9_samples4.csv,4,45196,1354,46550
T2_samples4.csv,T4_samples2.csv,4,12754,1039,13793
T2_samples4.csv,T9_samples1.csv,3,11657,2329,13986
T2_samples4.csv,T8_samples5.csv,4,10949,743,11692
T4_samples6.csv,T2_samples2.csv,3,18407,885,19292
T4_samples6.csv,T8_samples2.csv,5,14978,1044,16022
T4_samples6.csv,T1_samples5.csv,5,22879,1673,24552
T4_samples6.csv,T8_samples4.csv,4,8355,971,9326
T4_samples6.csv,T2_samples1.csv,2,16535,4467,21002
T4_samples6.csv,T8_samples1.csv,4,8720,989,9709
T4_samples6.csv,T8_samples7.csv,4,13877,882,14759
T4_samples6.csv,T9_samples3.csv,4,14462,890,15352
T4_samples6.csv,T8_samples3.csv,5,11457,946,12403
T4_samples6.csv,T8_samples5.csv,4,8394,972,9366
T4_samples6.csv,T9_samples1.csv,3,10508,831,11339
T9_samples4.csv,T4_samples7.csv,4,28011,805,28816
T9_samples4.csv,T2_samples2.csv,5,10797,892,11689
T9_samples4.csv,T1_samples4.csv,4,13842,1382,15224
T9_samples4.csv,T2_samples5.csv,3,24108,830,24938
T9_samples4.csv,T8_samples2.csv,5,25254,2266,27520
T9_samples4.csv,T4_samples3.csv,2,32916,825,33741
T9_samples4.csv,T4_samples1.csv,4,8607,5061,13668
T9_samples4.csv,T2_samples3.csv,2,7554,957,8511
T9_samples4.csv,T1_samples1.csv,4,14446,1251,15697
T9_samples4.csv,T2_samples1.csv,4,8146,955,9101
T9_samples4.csv,T1_samples3.csv,4,6600,941,7541
T9_samples4.csv,T2_samples4.csv,4,10536,796,11332
T9_samples4.csv,T8_samples1.csv,5,8634,776,9410
T9_samples4.csv,T4_samples2.csv,4,20077,834,20911
T9_samples4.csv,T8_samples5.csv,4,17265,898,18163
T8_samples1.csv,T4_samples7.csv,4,28544,821,29365
T8_samples1.csv,T2_samples2.csv,2,6988,2998,9986
T8_samples1.csv,T2_samples5.csv,3,14589,1394,15983
T8_samples1.csv,T9_samples2.csv,4,16132,1688,17820
T8_samples1.csv,T4_samples3.csv,3,24096,1106,25202
T8_samples1.csv,T2_samples3.csv,4,8021,1173,9194
T8_samples1.csv,T4_samples6.csv,4,9511,2009,11520
T8_samples1.csv,T9_samples4.csv,4,10010,1044,11054
T8_samples1.csv,T2_samples1.csv,3,14271,1073,15344
T8_samples1.csv,T1_samples3.csv,4,10231,984,11215
T8_samples1.csv,T9_samples3.csv,4,17996,937,18933
T8_samples1.csv,T4_samples2.csv,4,16473,1044,17517
T8_samples1.csv,T9_samples1.csv,3,8383,4817,13200
T8_samples7.csv,T2_samples2.csv,2,27391,944,28335
T8_samples7.csv,T4_samples3.csv,4,17070,962,18032
T8_samples7.csv,T4_samples1.csv,4,20950,1197,22147
T8_samples7.csv,T2_samples3.csv,2,8925,859,9784
T8_samples7.csv,T4_samples6.csv,5,12904,958,13862
T8_samples7.csv,T4_samples4.csv,4,11818,835,12653
T8_samples7.csv,T4_samples2.csv,4,15485,894,16379
T4_samples4.csv,T1_samples4.csv,4,23480,1012,24492
T4_samples4.csv,T8_samples7.csv,4,16624,800,17424
T2_samples1.csv,T9_samples2.csv,3,39154,1195,40349
T2_samples1.csv,T4_samples1.csv,4,17342,1529,18871
T2_samples1.csv,T9_samples4.csv,4,17887,850,18737
T2_samples1.csv,T4_samples6.csv,4,12179,821,13000
T2_samples1.csv,T1_samples3.csv,4,17648,2229,19877
T2_samples1.csv,T8_samples1.csv,5,11639,1081,12720
T2_samples1.csv,T9_samples3.csv,3,13229,824,14053
T2_samples1.csv,T4_samples2.csv,3,35273,1047,36320
T2_samples1.csv,T9_samples1.csv,3,8751,4555,13306
T4_samples3.csv,T8_samples6.csv,5,21838,1136,22974
T4_samples3.csv,T9_samples4.csv,4,14243,1047,15290
T4_samples3.csv,T8_samples1.csv,4,17232,1015,18247
T4_samples3.csv,T8_samples7.csv,4,24701,1627,26328
T4_samples3.csv,T8_samples5.csv,5,7499,907,8406
T8_samples5.csv,T4_samples7.csv,4,36081,921,37002
T8_samples5.csv,T1_samples5.csv,4,16899,976,17875
T8_samples5.csv,T4_samples3.csv,4,13430,990,14420
T8_samples5.csv,T4_samples1.csv,3,26911,1031,27942
T8_samples5.csv,T4_samples6.csv,5,11457,2361,13818
T8_samples5.csv,T9_samples4.csv,4,14783,1224,16007
T8_samples5.csv,T2_samples4.csv,3,23970,909,24879
T8_samples5.csv,T4_samples2.csv,3,16246,1819,18065
T8_samples5.csv,T9_samples1.csv,2,9523,900,10423
T8_samples3.csv,T4_samples7.csv,3,86429,6800,93229
T8_samples3.csv,T4_samples5.csv,4,41569,2266,43835
T8_samples3.csv,T4_samples6.csv,4,10974,127156,138130
T8_samples3.csv,T1_samples1.csv,4,32948,1925,34873
T1_samples5.csv,T2_samples5.csv,5,39945,2390,42335
T1_samples5.csv,T2_samples3.csv,5,2816,36767,39583
T1_samples5.csv,T4_samples6.csv,5,1432,30506,31938
T1_samples5.csv,T8_samples5.csv,3,2510,248697,251207
T4_samples2.csv,T2_samples2.csv,4,2916,37610,40526
T4_samples2.csv,T2_samples5.csv,3,1792,57975,59767
T4_samples2.csv,T8_samples2.csv,4,1423,42352,43775
T4_samples2.csv,T8_samples4.csv,5,1480,25824,27304
T4_samples2.csv,T9_samples4.csv,3,1726,39938,41664
T4_samples2.csv,T2_samples3.csv,2,1563,139741,141304
T4_samples2.csv,T2_samples1.csv,4,2308,32316,34624
T4_samples2.csv,T2_samples4.csv,2,1003,47342,48345
T4_samples2.csv,T8_samples1.csv,4,1604,54318,55922
T4_samples2.csv,T8_samples7.csv,5,984,31238,32222
T4_samples2.csv,T8_samples5.csv,5,1264,31352,32616
T2_samples2.csv,T4_samples7.csv,3,1606,40049,41655
T2_samples2.csv,T9_samples2.csv,4,1620,34834,36454
T2_samples2.csv,T8_samples6.csv,5,1481,39807,41288
T2_samples2.csv,T4_samples1.csv,4,1377,60327,61704
T2_samples2.csv,T4_samples6.csv,3,1388,45772,47160
T2_samples2.csv,T9_samples4.csv,4,977,50903,51880
T2_samples2.csv,T1_samples3.csv,5,1416,27224,28640
T2_samples2.csv,T8_samples1.csv,5,1194,71102,72296
T2_samples2.csv,T8_samples7.csv,5,1097,40104,41201
T2_samples2.csv,T9_samples3.csv,5,1129,32320,33449
T2_samples2.csv,T4_samples2.csv,3,750,44041,44791
T2_samples2.csv,T8_samples5.csv,4,841,35151,35992
T2_samples2.csv,T9_samples1.csv,5,931,28198,29129
T8_samples5.csv,T4_samples7.csv,4,1403,44796,46199
T8_samples5.csv,T2_samples2.csv,4,1636,53050,54686
T8_samples5.csv,T1_samples5.csv,2,1083,31092,32175
T8_samples5.csv,T4_samples3.csv,2,1924,73788,75712
T8_samples5.csv,T4_samples1.csv,3,1346,41413,42759
T8_samples5.csv,T4_samples6.csv,4,655,60413,61068
T8_samples5.csv,T9_samples4.csv,4,686,40297,40983
T8_samples5.csv,T2_samples4.csv,4,550,33639,34189
T8_samples5.csv,T4_samples2.csv,5,647,27402,28049
T8_samples5.csv,T9_samples1.csv,3,1099,37701,38800
T2_samples4.csv,T4_samples7.csv,4,43730,12990,56720
T2_samples4.csv,T9_samples2.csv,4,2102,29720,31822
T2_samples4.csv,T8_samples2.csv,3,1363,35414,36777
T2_samples4.csv,T4_samples1.csv,3,704,30536,31240
T2_samples4.csv,T9_samples4.csv,4,964,44213,45177
T2_samples4.csv,T4_samples2.csv,4,583,30402,30985
T2_samples4.csv,T9_samples1.csv,5,700,30155,30855
T2_samples4.csv,T8_samples5.csv,4,746,52015,52761
T8_samples4.csv,T4_samples7.csv,2,2091,34474,36565
T8_samples4.csv,T4_samples5.csv,3,840,51218,52058
T8_samples4.csv,T4_samples6.csv,3,1234,36500,37734
T8_samples4.csv,T1_samples1.csv,5,1384,29583,30967
T8_samples4.csv,T4_samples2.csv,5,744,34417,35161
T9_samples2.csv,T4_samples7.csv,5,2078,35263,37341
T9_samples2.csv,T2_samples2.csv,4,1066,41286,42352
T9_samples2.csv,T2_samples5.csv,5,2615,37232,39847
T9_samples2.csv,T2_samples3.csv,2,772,27933,28705
T9_samples2.csv,T1_samples1.csv,4,1614,36832,38446
T9_samples2.csv,T2_samples1.csv,4,683,24055,24738
T9_samples2.csv,T1_samples3.csv,2,815,29425,30240
T9_samples2.csv,T2_samples4.csv,5,591,24081,24672
T9_samples2.csv,T8_samples1.csv,3,702,29306,30008
T8_samples1.csv,T4_samples7.csv,4,1289,54983,56272
T8_samples1.csv,T2_samples2.csv,5,1647,41983,43630
T8_samples1.csv,T2_samples5.csv,3,1800,31897,33697
T8_samples1.csv,T9_samples2.csv,4,919,38838,39757
T8_samples1.csv,T4_samples3.csv,3,914,64501,65415
T8_samples1.csv,T2_samples3.csv,2,747,24733,25480
T8_samples1.csv,T4_samples6.csv,4,934,55261,56195
T8_samples1.csv,T9_samples4.csv,5,768,21062,21830
T8_samples1.csv,T2_samples1.csv,5,777,33496,34273
T8_samples1.csv,T1_samples3.csv,4,1154,34062,35216
T8_samples1.csv,T9_samples3.csv,5,938,23486,24424
T8_samples1.csv,T4_samples2.csv,4,794,33448,34242
T8_samples1.csv,T9_samples1.csv,3,733,30850,31583
T4_samples4.csv,T1_samples4.csv,4,1797,37465,39262
T4_samples4.csv,T8_samples7.csv,4,1535,30898,32433
T1_samples5.csv,T2_samples5.csv,5,1614,22352,23966
T1_samples5.csv,T2_samples3.csv,4,1094,29593,30687
T1_samples5.csv,T4_samples6.csv,5,1008,31071,32079
T1_samples5.csv,T8_samples5.csv,4,2413,33196,35609
T4_samples5.csv,T8_samples2.csv,4,1332,40472,41804
T4_samples5.csv,T8_samples4.csv,2,844,38296,39140
T4_samples5.csv,T8_samples3.csv,4,1037,65440,66477
T4_samples5.csv,T8_samples2.csv,5,2004,40275,42279
T4_samples5.csv,T8_samples4.csv,3,3121,45590,48711
T4_samples5.csv,T8_samples3.csv,3,810,49357,50167
T4_samples2.csv,T2_samples2.csv,2,886,66973,67859
T4_samples2.csv,T2_samples5.csv,4,962,30389,31351
T4_samples2.csv,T8_samples2.csv,5,892,37847,38739
T4_samples2.csv,T8_samples4.csv,5,1021,36830,37851
T4_samples2.csv,T9_samples4.csv,4,751,35348,36099
T4_samples2.csv,T2_samples3.csv,2,599,28414,29013
T4_samples2.csv,T2_samples1.csv,4,707,33199,33906
T4_samples2.csv,T2_samples4.csv,4,718,22754,23472
T4_samples2.csv,T8_samples1.csv,4,546,34318,34864
T4_samples2.csv,T8_samples7.csv,4,1049,27007,28056
T4_samples2.csv,T8_samples5.csv,4,656,27849,28505
T4_samples1.csv,T2_samples2.csv,3,1835,32858,34693
T4_samples1.csv,T9_samples4.csv,3,9814,31175,40989
T4_samples1.csv,T2_samples1.csv,3,1291,47188,48479
T4_samples1.csv,T2_samples4.csv,4,727,36930,37657
T4_samples1.csv,T8_samples7.csv,4,1275,29749,31024
T4_samples1.csv,T9_samples1.csv,4,767,36547,37314
T4_samples1.csv,T8_samples5.csv,3,1179,50923,52102
T1_samples5.csv,T2_samples5.csv,5,2792,30749,33541
T1_samples5.csv,T2_samples3.csv,4,903,24441,25344
T1_samples5.csv,T4_samples6.csv,5,725,24348,25073
T1_samples5.csv,T8_samples5.csv,4,1367,39657,41024
T2_samples2.csv,T4_samples7.csv,4,1425,39062,40487
T2_samples2.csv,T9_samples2.csv,5,848,34503,35351
T2_samples2.csv,T8_samples6.csv,3,2265,35311,37576
T2_samples2.csv,T4_samples1.csv,4,1668,44541,46209
T2_samples2.csv,T4_samples6.csv,5,1629,33099,34728
T2_samples2.csv,T9_samples4.csv,5,1252,29108,30360
T2_samples2.csv,T1_samples3.csv,4,1291,27605,28896
T2_samples2.csv,T8_samples1.csv,5,1063,30657,31720
T2_samples2.csv,T8_samples7.csv,4,942,31242,32184
T2_samples2.csv,T9_samples3.csv,5,1307,21917,23224
T2_samples2.csv,T4_samples2.csv,5,1616,27152,28768
T2_samples2.csv,T8_samples5.csv,4,4831,47233,52064
T2_samples2.csv,T9_samples1.csv,5,1137,28559,29696
T8_samples3.csv,T4_samples7.csv,4,991,104807,105798
T8_samples3.csv,T4_samples5.csv,3,1158,38542,39700
T8_samples3.csv,T4_samples6.csv,4,949,41568,42517
T8_samples3.csv,T1_samples1.csv,4,717,35754,36471
T8_samples1.csv,T4_samples7.csv,4,2724,51714,54438
T8_samples1.csv,T2_samples2.csv,5,1486,30825,32311
T8_samples1.csv,T2_samples5.csv,4,1707,37085,38792
T8_samples1.csv,T9_samples2.csv,5,734,38201,38935
T8_samples1.csv,T4_samples3.csv,2,1267,30925,32192
T8_samples1.csv,T2_samples3.csv,3,807,28898,29705
T8_samples1.csv,T4_samples6.csv,2,570,23678,24248
T8_samples1.csv,T9_samples4.csv,5,601,19999,20600
T8_samples1.csv,T2_samples1.csv,4,736,25503,26239
T8_samples1.csv,T1_samples3.csv,2,729,21975,22704
T8_samples1.csv,T9_samples3.csv,4,742,32154,32896
T8_samples1.csv,T4_samples2.csv,5,744,38704,39448
T2_samples3.csv,T4_samples7.csv,5,4927,49498,54425
T2_samples3.csv,T1_samples4.csv,4,1738,29149,30887
T2_samples3.csv,T9_samples2.csv,5,1216,25720,26936
T2_samples3.csv,T1_samples5.csv,4,745,35928,36673
T2_samples3.csv,T9_samples4.csv,5,1441,31249,32690
T2_samples3.csv,T1_samples3.csv,5,2136,31399,33535
T2_samples3.csv,T8_samples1.csv,4,799,31783,32582
T2_samples3.csv,T8_samples7.csv,5,1003,25462,26465
T2_samples3.csv,T9_samples3.csv,5,904,30337,31241
T2_samples3.csv,T4_samples2.csv,4,681,24654,25335
T2_samples3.csv,T9_samples1.csv,4,1511,23505,25016
T4_samples2.csv,T2_samples2.csv,3,1081,44102,45183
T4_samples2.csv,T2_samples5.csv,3,1197,44144,45341
T4_samples2.csv,T8_samples2.csv,4,374,27364,27738
T4_samples2.csv,T8_samples4.csv,4,1402,32045,33447
T4_samples2.csv,T9_samples4.csv,4,1623,31737,33360
T4_samples2.csv,T2_samples3.csv,4,1963,28005,29968
T4_samples2.csv,T2_samples1.csv,4,1326,32027,33353
T4_samples2.csv,T2_samples4.csv,4,1090,28734,29824
T4_samples2.csv,T8_samples1.csv,5,750,28649,29399
T4_samples2.csv,T8_samples7.csv,5,1049,20872,21921
T4_samples2.csv,T8_samples5.csv,4,715,21046,21761
T2_samples1.csv,T9_samples2.csv,5,1299,33195,34494
T2_samples1.csv,T4_samples1.csv,4,1151,43642,44793
T2_samples1.csv,T9_samples4.csv,5,1658,21117,22775
T2_samples1.csv,T4_samples6.csv,4,966,29263,30229
T2_samples1.csv,T1_samples3.csv,3,597,30362,30959
T2_samples1.csv,T8_samples1.csv,4,915,27429,28344
T2_samples1.csv,T9_samples3.csv,5,1754,22787,24541
T2_samples1.csv,T4_samples2.csv,5,768,28459,29227
T2_samples1.csv,T9_samples1.csv,5,1073,24711,25784
T8_samples4.csv,T4_samples7.csv,5,721,556854,557575
T8_samples4.csv,T4_samples5.csv,4,2329,38283,40612
T8_samples4.csv,T4_samples6.csv,3,1034,37030,38064
T8_samples4.csv,T1_samples1.csv,4,685,21740,22425
T8_samples4.csv,T4_samples2.csv,5,962,23806,24768
T2_samples2.csv,T4_samples7.csv,3,85766,49744,135510
T2_samples2.csv,T9_samples2.csv,4,1384,35551,36935
T2_samples2.csv,T8_samples6.csv,4,32197,35223,67420
T2_samples2.csv,T4_samples1.csv,5,912,31085,31997
T2_samples2.csv,T4_samples6.csv,5,915,28802,29717
T2_samples2.csv,T9_samples4.csv,4,915,33622,34537
T2_samples2.csv,T1_samples3.csv,4,1059,24399,25458
T2_samples2.csv,T8_samples1.csv,5,821,22073,22894
T2_samples2.csv,T8_samples7.csv,4,794,23454,24248
T2_samples2.csv,T9_samples3.csv,5,827,18846,19673
T2_samples2.csv,T4_samples2.csv,4,787,33900,34687
T2_samples2.csv,T8_samples5.csv,4,984,30975,31959
T2_samples2.csv,T9_samples1.csv,4,692,25270,25962
T8_samples6.csv,T4_samples7.csv,4,1407,61297,62704
T8_samples6.csv,T2_samples2.csv,5,1161,32318,33479
T8_samples6.csv,T4_samples3.csv,4,1682,31790,33472
T8_samples6.csv,T4_samples1.csv,5,943,24515,25458
T8_samples6.csv,T9_samples1.csv,5,685,23241,23926
T1_samples3.csv,T2_samples2.csv,4,806,281576,282382
T1_samples3.csv,T9_samples2.csv,3,851,21114,21965
T1_samples3.csv,T9_samples4.csv,3,1037,27949,28986
T1_samples3.csv,T2_samples3.csv,4,1007,20625,21632
T1_samples3.csv,T2_samples1.csv,4,1175,22729,23904
T1_samples3.csv,T8_samples1.csv,4,871,18279,19150
T2_samples4.csv,T4_samples7.csv,5,639,404505,405144
T2_samples4.csv,T9_samples2.csv,5,910,22056,22966
T2_samples4.csv,T8_samples2.csv,3,876,48395,49271
T2_samples4.csv,T4_samples1.csv,5,923,28549,29472
T2_samples4.csv,T9_samples4.csv,5,1448,37888,39336
T2_samples4.csv,T4_samples2.csv,4,915,19950,20865
T2_samples4.csv,T9_samples1.csv,4,967,19497,20464
T2_samples4.csv,T8_samples5.csv,3,752,27471,28223
T9_samples2.csv,T4_samples7.csv,4,792,1009746,1010538
T9_samples2.csv,T2_samples2.csv,4,1012,33285,34297
T9_samples2.csv,T2_samples5.csv,5,996,17685,18681
T9_samples2.csv,T2_samples3.csv,5,22612,5476,28088
T9_samples2.csv,T1_samples1.csv,4,1558,34586,36144
T9_samples2.csv,T2_samples1.csv,4,901,26739,27640
T9_samples2.csv,T1_samples3.csv,3,892,23332,24224
T9_samples2.csv,T2_samples4.csv,4,952,36263,37215
T9_samples2.csv,T8_samples1.csv,5,872,25513,26385
T4_samples2.csv,T2_samples2.csv,4,710,1070235,1070945
T4_samples2.csv,T2_samples5.csv,5,1197,39115,40312
T4_samples2.csv,T8_samples2.csv,4,2084,41617,43701
T4_samples2.csv,T8_samples4.csv,5,815,29782,30597
T4_samples2.csv,T9_samples4.csv,5,904,20150,21054
T4_samples2.csv,T2_samples3.csv,4,834,21845,22679
T4_samples2.csv,T2_samples1.csv,5,1686,23938,25624
T4_samples2.csv,T2_samples4.csv,4,712,31192,31904
T4_samples2.csv,T8_samples1.csv,5,741,21532,22273
T4_samples2.csv,T8_samples7.csv,4,783,25009,25792
T4_samples2.csv,T8_samples5.csv,5,760,20784,21544
T1_samples1.csv,T4_samples7.csv,5,849,1672429,1673278
T1_samples1.csv,T9_samples2.csv,4,1062,28489,29551
T1_samples1.csv,T8_samples4.csv,5,740,30372,31112
T1_samples1.csv,T9_samples4.csv,5,728,18784,19512
T1_samples1.csv,T8_samples3.csv,4,934,30156,31090
T4_samples3.csv,T8_samples6.csv,4,2133,39438,41571
T4_samples3.csv,T9_samples4.csv,4,912,49682,50594
T4_samples3.csv,T8_samples1.csv,3,661,35578,36239
T4_samples3.csv,T8_samples7.csv,3,880,34824,35704
T4_samples3.csv,T8_samples5.csv,4,1642,30661,32303
T4_samples6.csv,T2_samples2.csv,2,246127,71496,317623
T4_samples6.csv,T8_samples2.csv,3,977,40110,41087
T4_samples6.csv,T1_samples5.csv,3,741,24267,25008
T4_samples6.csv,T8_samples4.csv,4,949,26489,27438
T4_samples6.csv,T2_samples1.csv,3,895,27658,28553
T4_samples6.csv,T8_samples1.csv,4,908,21373,22281
T4_samples6.csv,T8_samples7.csv,4,696,26873,27569
T4_samples6.csv,T9_samples3.csv,4,930,21294,22224
T4_samples6.csv,T8_samples3.csv,4,736,24905,25641
T4_samples6.csv,T8_samples5.csv,3,777,39278,40055
T4_samples6.csv,T9_samples1.csv,4,791,26472,27263
T8_samples6.csv,T4_samples7.csv,4,1446,31927,33373
T8_samples6.csv,T2_samples2.csv,5,903,23552,24455
T8_samples6.csv,T4_samples3.csv,5,900,32437,33337
T8_samples6.csv,T4_samples1.csv,5,2431,24959,27390
T8_samples6.csv,T9_samples1.csv,5,741,29260,30001
T9_samples3.csv,T4_samples7.csv,2,1198,252310,253508
T9_samples3.csv,T2_samples2.csv,5,1386,26696,28082
T9_samples3.csv,T2_samples5.csv,4,887,40992,41879
T9_samples3.csv,T2_samples3.csv,4,905,33520,34425
T9_samples3.csv,T4_samples6.csv,4,882,25198,26080
T9_samples3.csv,T2_samples1.csv,5,883,24981,25864
T9_samples3.csv,T8_samples1.csv,5,1188,27500,28688
T2_samples3.csv,T4_samples7.csv,3,500575,48329,548904
T2_samples3.csv,T1_samples4.csv,4,732,26737,27469
T2_samples3.csv,T9_samples2.csv,3,1013,29932,30945
T2_samples3.csv,T1_samples5.csv,4,1086,25411,26497
T2_samples3.csv,T9_samples4.csv,3,821,24250,25071
T2_samples3.csv,T1_samples3.csv,4,852,22981,23833
T2_samples3.csv,T8_samples1.csv,3,784,26904,27688
T2_samples3.csv,T8_samples7.csv,3,697,30847,31544
T2_samples3.csv,T9_samples3.csv,4,886,32738,33624
T2_samples3.csv,T4_samples2.csv,3,895,23001,23896
T2_samples3.csv,T9_samples1.csv,4,917,23322,24239
T4_samples3.csv,T8_samples6.csv,5,783,1024609,1025392
T4_samples3.csv,T9_samples4.csv,4,775,28762,29537
T4_samples3.csv,T8_samples1.csv,4,905,28039,28944
T4_samples3.csv,T8_samples7.csv,4,744,34936,35680
T4_samples3.csv,T8_samples5.csv,4,697,24999,25696
T1_samples1.csv,T4_samples7.csv,5,1457,397840,399297
T1_samples1.csv,T9_samples2.csv,4,952,31582,32534
T1_samples1.csv,T8_samples4.csv,4,851,38436,39287
T1_samples1.csv,T9_samples4.csv,4,898,32631,33529
T1_samples1.csv,T8_samples3.csv,5,1599,20035,21634
T4_samples5.csv,T8_samples2.csv,5,465634,51984,517618
T4_samples5.csv,T8_samples4.csv,5,2027,28884,30911
T4_samples5.csv,T8_samples3.csv,5,2549,79237,81786
T2_samples4.csv,T4_samples7.csv,4,4983,20591,25574
T2_samples4.csv,T9_samples2.csv,5,1244,29202,30446
T2_samples4.csv,T8_samples2.csv,3,964,31260,32224
T2_samples4.csv,T4_samples1.csv,5,1158,30370,31528
T2_samples4.csv,T9_samples4.csv,5,947,29317,30264
T2_samples4.csv,T4_samples2.csv,4,3183,22898,26081
T2_samples4.csv,T9_samples1.csv,5,867,198775,199642
T2_samples4.csv,T8_samples5.csv,4,21858,417862,439720
T2_samples5.csv,T4_samples7.csv,4,208544,48369,256913
T2_samples5.csv,T9_samples2.csv,5,989,81325,82314
T2_samples5.csv,T8_samples2.csv,3,2011,31822,33833
T2_samples5.csv,T1_samples5.csv,3,822,20658,21480
T2_samples5.csv,T9_samples4.csv,5,811,33069,33880
T2_samples5.csv,T8_samples1.csv,4,880,30383,31263
T2_samples5.csv,T9_samples3.csv,3,935,20594,21529
T2_samples5.csv,T4_samples2.csv,5,771,24598,25369
T2_samples5.csv,T9_samples1.csv,4,886,33058,33944
T9_samples4.csv,T4_samples7.csv,4,565506,41207,606713
T9_samples4.csv,T2_samples2.csv,4,832,29856,30688
T9_samples4.csv,T1_samples4.csv,3,37575,1889,39464
T9_samples4.csv,T2_samples5.csv,5,1345,22607,23952
T9_samples4.csv,T8_samples2.csv,4,1093,50348,51441
T9_samples4.csv,T4_samples3.csv,3,786,34799,35585
T9_samples4.csv,T4_samples1.csv,5,752,32446,33198
T9_samples4.csv,T2_samples3.csv,3,767,22298,23065
T9_samples4.csv,T1_samples1.csv,4,638,17849,18487
T9_samples4.csv,T2_samples1.csv,4,786,32429,33215
T9_samples4.csv,T1_samples3.csv,3,984,22480,23464
T9_samples4.csv,T2_samples4.csv,5,752,19400,20152
T9_samples4.csv,T8_samples1.csv,4,770,28276,29046
T9_samples4.csv,T4_samples2.csv,5,944,30337,31281
T9_samples4.csv,T8_samples5.csv,5,809,29744,30553
T9_samples1.csv,T4_samples7.csv,4,1959160,37490,1996650
T9_samples1.csv,T2_samples2.csv,4,675,32181,32856
T9_samples1.csv,T2_samples5.csv,5,1069,37649,38718
T9_samples1.csv,T8_samples2.csv,4,2210,37263,39473
T9_samples1.csv,T8_samples6.csv,4,863,23713,24576
T9_samples1.csv,T4_samples1.csv,5,1002,30158,31160
T9_samples1.csv,T4_samples6.csv,4,694,24355,25049
T9_samples1.csv,T2_samples3.csv,4,775,16815,17590
T9_samples1.csv,T2_samples1.csv,4,802,23824,24626
T9_samples1.csv,T2_samples4.csv,3,795,15564,16359
T9_samples1.csv,T8_samples1.csv,3,800,894855,895655
T9_samples1.csv,T8_samples5.csv,3,754,29468,30222
T4_samples7.csv,T2_samples2.csv,3,220478,55712,276190
T4_samples7.csv,T9_samples2.csv,4,952,52405,53357
T4_samples7.csv,T2_samples5.csv,3,708,22950,23658
T4_samples7.csv,T8_samples2.csv,4,716,29780,30496
T4_samples7.csv,T8_samples6.csv,4,905,22285,23190
T4_samples7.csv,T8_samples4.csv,5,781,19381,20162
T4_samples7.csv,T2_samples3.csv,4,887,16589,17476
T4_samples7.csv,T9_samples4.csv,5,759,25820,26579
T4_samples7.csv,T1_samples1.csv,4,966,25898,26864
T4_samples7.csv,T2_samples4.csv,4,800,18763,19563
T4_samples7.csv,T8_samples1.csv,4,755,39634,40389
T4_samples7.csv,T9_samples3.csv,4,918,28435,29353
T4_samples7.csv,T8_samples3.csv,5,881,25167,26048
T4_samples7.csv,T8_samples5.csv,4,932,25572,26504
T4_samples7.csv,T9_samples1.csv,3,962,21109,22071
T8_samples2.csv,T4_samples7.csv,5,452375,66882,519257
T8_samples2.csv,T2_samples5.csv,4,877,42096,42973
T8_samples2.csv,T4_samples5.csv,3,971,175120,176091
T8_samples2.csv,T4_samples6.csv,5,863,29945,30808
T8_samples2.csv,T9_samples4.csv,4,823,37985,38808
T8_samples2.csv,T2_samples4.csv,4,817,25314,26131
T8_samples2.csv,T4_samples2.csv,4,869,26919,27788
T8_samples2.csv,T9_samples1.csv,4,914,40751,41665
T8_samples7.csv,T2_samples2.csv,3,321529,54222,375751
T8_samples7.csv,T4_samples3.csv,5,1938,22183,24121
T8_samples7.csv,T4_samples1.csv,4,916,24718,25634
T8_samples7.csv,T2_samples3.csv,4,1941,26081,28022
T8_samples7.csv,T4_samples6.csv,5,962,26614,27576
T8_samples7.csv,T4_samples4.csv,4,784,23793,24577
T8_samples7.csv,T4_samples2.csv,4,892,31948,32840
T4_samples7.csv,T2_samples2.csv,3,303904,50338,354242
T4_samples7.csv,T9_samples2.csv,5,989,29001,29990
T4_samples7.csv,T2_samples5.csv,3,1698,57350,59048
T4_samples7.csv,T8_samples2.csv,4,916,48051,48967
T4_samples7.csv,T8_samples6.csv,4,899,42222,43121
T4_samples7.csv,T8_samples4.csv,4,845,27421,28266
T4_samples7.csv,T2_samples3.csv,4,876,25138,26014
T4_samples7.csv,T9_samples4.csv,5,799,20200,20999
T4_samples7.csv,T1_samples1.csv,5,1016,21104,22120
T4_samples7.csv,T2_samples4.csv,4,831,29209,30040
T4_samples7.csv,T8_samples1.csv,5,773,27068,27841
T4_samples7.csv,T9_samples3.csv,4,862,20713,21575
T4_samples7.csv,T8_samples3.csv,4,941,28515,29456
T4_samples7.csv,T8_samples5.csv,5,1467,28132,29599
T4_samples7.csv,T9_samples1.csv,3,819,22541,23360
T2_samples2.csv,T4_samples7.csv,3,1677,69463,71140
T8_samples6.csv,T4_samples7.csv,4,366507,103223,469730
T8_samples6.csv,T2_samples2.csv,3,1081,34446,35527
T8_samples6.csv,T4_samples3.csv,3,1120,38174,39294
T8_samples6.csv,T4_samples1.csv,2,925,23596,24521
T8_samples6.csv,T9_samples1.csv,4,903,39313,40216
T9_samples3.csv,T4_samples7.csv,3,1816,56550,58366
T9_samples3.csv,T2_samples2.csv,4,838,20224,21062
T9_samples3.csv,T2_samples5.csv,3,925,26924,27849
T9_samples3.csv,T2_samples3.csv,4,5241,39370,44611
T9_samples3.csv,T4_samples6.csv,3,983,32889,33872
T9_samples3.csv,T2_samples1.csv,5,944,21789,22733
T9_samples3.csv,T8_samples1.csv,4,911,25563,26474
T8_samples2.csv,T4_samples7.csv,5,392183,46896,439079
T8_samples2.csv,T2_samples5.csv,4,2742,33376,36118
T8_samples2.csv,T4_samples5.csv,3,797,34340,35137
T8_samples2.csv,T4_samples6.csv,3,1012,20326,21338
T8_samples2.csv,T9_samples4.csv,5,853,26569,27422
T8_samples2.csv,T2_samples4.csv,4,1119,31016,32135
T8_samples2.csv,T4_samples2.csv,4,934,22933,23867
T8_samples2.csv,T9_samples1.csv,3,1099,19682,20781
T1_samples1.csv,T4_samples7.csv,5,887548,40056,927604
T1_samples1.csv,T9_samples2.csv,5,1415,15999,17414
T1_samples1.csv,T8_samples4.csv,4,934,23394,24328
T1_samples1.csv,T9_samples4.csv,3,875,23813,24688
T1_samples1.csv,T8_samples3.csv,5,984,21273,22257
T9_samples3.csv,T4_samples7.csv,3,432865,37682,470547
T9_samples3.csv,T2_samples2.csv,5,830,24680,25510
T9_samples3.csv,T2_samples5.csv,4,853,36322,37175
T9_samples3.csv,T2_samples3.csv,3,893,27802,28695
T9_samples3.csv,T4_samples6.csv,3,766,37170,37936
T9_samples3.csv,T2_samples1.csv,5,760,23961,24721
T9_samples3.csv,T8_samples1.csv,5,1009,28408,29417
